she=KANOJO
he=KARE
name=NAMAE
bag=KABAN
clock=TOKEI
pencase=FUDEBAKO
notebook=NO-TO
bottle=BOTORU
table/desk=TSUKUE
hat=BOUSHI
eye glasses=MEGANE
chair=ISU
wall=KABE
door=DOA
wallet=SAIFU
wrist watch=UDEDOKEI
clothes=FUKU
paper=KAMI
shoe(s)=KUTSU
money=OKANE
book=HON
floor=YUKA
ceiling=TENJOU
window=MADO
lamp=RANPU
water=MIZU
good morning=OHAYOU GOZAIMAS
good afternoon=KONNICHIWA
good evening=KONBANWA
this (these)=KORE
pen(s)=PEN
key(s)=KAGI
pc=PC
pokemon=POCKETO MONSTER
my/me=WATASI
mobile phone=KEITAI
you, your=ANATA
yes=HAI
no=IIE
china=CHUUGOKU
south korea=KANKOKU
spain=SUPEIN
france=FURANSU
greece=GIRISHA
turkey=TORUKO
united kingdom=IGIRISU
belgium=BERUGI- (PRONOUNCED: BERUGII)
netherlands=ORANDA
switzerland=SUISU
usa=AMERIKA
germany=DOITSU
italy=ITARIA
person=HITO
person [respect form]=KATA
poland=PO-RANDO
city/town=MACHI
village=MURA
university=DAIGAKU
school=GAKKOU
company=KAISHA
pwr=WROCLAW KOUKA DAIGAKU
which=DOCHIRA
here=KOKO
there=SOKO
over there=ASOKO
post office=YUUBINKYOKU
police station=KEISATSUSHO
church=KYOUKAI
park=KOUEN
bank=GINKOU
theatre=GEKIJOU
cinema=EIGAKAN
museum=HAKUBUTSUKAN
library=TOSHOKAN
1=ICHI
2=NI
3=SAN
4=YON
5=GO
6=ROKU
7=NANA
8=HACHI
9=KYUU
10=JUU
which one (when there are 3 choices or more)=DORE
which one (when there are only 2 choices)=DOCHIRA
railway station=EKI
pub=PABU
swimming pool=PU-RU
shop=MISE
hospital=BYOUIN
airport=KUUKOU
toilet=TOIRE
temple=OTERA
castle=OSHIRO
head=ATAMA
face=KAO
eye(s)=ME
nose=HANA
mouth=KUCHI
hair=KAMI
body=KARADA
neck=KUBI
shoulder(s)=KATA
arm(s)=UDE
hand(s)=TE
chest=MUNE
stomach=ONAKA
leg(s)=ASHI
back=SENAKA
home/house=IE
europe=YO-ROPPA
this x=KONO X
that x=SONO X
that x=ANO X
entrance=IRIGUCHI
chimney=ENTOTSU
roof=YANE
kitchen=KITCHEN, DAIDOKORO
room=HEYA
garden=NIWA
sink=NAGASHI
bathroom=FUROBA
shower=SHAWA-
bath=OFURO
towel=TAORU
mirror=KAGAMI
CALLIGRAPHY PAPER=SENMENJO
tv=TEREBI
remote controller=RIMOKON
bed=BEDDO
radio=RAJIO
oven=O-BUN
chopsticks=HASHI
refrigerator=REIZOUKO
microwave=DENSHI RENJI
car=KURUMA
motorbike=BAIKU
bicycle=JITENSHA
up=UE
down=SHITA
right=MIGI
left=HIDARI
next to=YOKO
inside=NAKA
outside=SOTO
front / forward=MAE
back / behind=USHIRO
letter=TEGAMI
plates=SARA
kettle=YAKAN
glass=GURASU
cup=KOPPU
magazine=ZASSHI
telephone=DENWA
cat=NEKO
dog=INU
bird=TORI
pigeon=HATO
monkey=SARU
kazoku=FAMILY
father=CHICHI, OTOUSAN
mother=HAHA, OKAASAN
friend(s)=TOMODACHI
pet=PETTO
turtle=KAME
rabbit=USAGI
snake=HEBI
fish=SAKANA
horse=UMA
mouse=NEZUMI
chicken=NIWATORI
cow=USHI
pig=BUTA
lion=RAION
tiger=TORA
elephant=ZOU
bear=KUMA
fox=KITSUNE
animal=DOUBUTSU
zoo=DOUBUTSUEN
plants=SHOKUBUTSU
botanical garden=SHOKUBUTSUEN
today=KYOU
tomorrow=ASHITA
mountain=YAMA
sea=UMI
lake=MIZUUMI
forest=MORI
river=KAWA
work=SHIGOTO
they (guy and rest)=KARERA
they=KANOJORA
We=WATASHITACHI
You(plural)=ANATATACHI
or=SORETOMO
now=IMA
from x=X KARA
kaeru=TO GO (HOME), COME (HOME), GO BACK TO, COME BACK TO
bus=BASU
tramway=TORAMU
train=DENSHA/KISHA
airplane=HIKOUKI
ship=FUNE
